################
#..............#
#..............#
#..............#
#..............#
#..............#
#......##......#
#..............#
#..............#
#..............#
#.......##.....#
#..............#
#..............#
#..............#
#..............#
################